2*3*2#6*8*9
*##********
1*4*8*0*6*2
***********
3*5*8*4*6#1
**#********
4*0#2*3*9#2
*#******#**
6#8*9*1#2*0
***********
5#3*6*2#3*4
******#****
6*3*5*6*9*1

start: (10,0)
end:   (2,10)